0
10
10
1111100000
1000101000
1000111000
1110100000
1000100000
1000111111
1100111111
1000111111
1000111111
1000000000
0000000000
0000303000
0000033000
0330000000
3000000000
0000000000
0200000040
2000004400
0000000400
6000000000