3
9
9
111000111
111000111
111000111
111111111
001111100
111111111
111000111
111000111
111000111
040000050
050000040
005000400
000303000
000060000
000404000
005000500
030000030
000000000
